1163 1164 1165 1166 1163 1164 1165 1166 1163 1164 1165 1166 1163 1164 1165 1166 1163 1164 1165 1166 1163 1164 1165 1166 1163 1164 1165 1166 1163 1164 1165 1166 1163 1164 1165 1166 1163 1164 1165 1166 1163 1164 1165 1166 1163 1164 1165 1166 1163 1164 1165 1166 1163 1164 1165 1166 1163 1164 1165 1166 1163 1164 1165 1166 1163 1164 1165 1166 1163 1164 1165 1166 1163 1164 1165 1166 1163 1164 1165 1166 1163 1164 1165 1166 1163
1227 1228 1229 1230 1227 1228 1229 1230 1227 1228 1229 1230 1227 1228 1229 1230 1227 1228 1229 1230 1227 1228 1229 1230 1227 1228 1229 1230 1227 1228 1229 1230 1227 1228 1229 1230 1227 1228 1229 1230 1227 1228 1229 1230 1227 1228 1229 1230 1227 1228 1229 1230 1227 1228 1229 1230 1227 1228 1229 1230 1227 1228 1229 1230 1227 1228 1229 1230 1227 1228 1229 1230 1227 1228 1229 1230 1227 1228 1229 1230 1227 1228 1229 1230 1227
1291 1292 1293 1294 1291 1292 1293 1294 1291 1292 1293 1294 1291 1292 1293 1294 1291 1292 1293 1294 1291 1292 1293 1294 1291 1292 1293 1294 1291 1292 1293 1294 1291 1292 1293 1294 1291 1292 1293 1294 1291 1292 1293 1294 1291 1292 1293 1294 1291 1292 1293 1294 1291 1292 1293 1294 1291 1292 1293 1294 1291 1292 1293 1294 1291 1292 1293 1294 1291 1292 1293 1294 1291 1292 1293 1294 1291 1292 1293 1294 1291 1292 1293 1294 1291
1355 1356 1357 1358 1355 1356 1357 1358 1355 1356 1357 1358 1355 1356 1357 1358 1355 1356 1357 1358 1355 1356 1357 1358 1355 1356 1357 1358 1355 1356 1357 1358 1355 1356 1357 1358 1355 1356 1357 1358 1355 1356 1357 1358 1355 1356 1357 1358 1355 1356 1357 1358 1355 1356 1357 1358 1355 1356 1357 1358 1355 1356 1357 1358 1355 1356 1357 1358 1355 1356 1357 1358 1355 1356 1357 1358 1355 1356 1357 1358 1355 1356 1357 1358 1355
1163 1164 1165 1166 1163 1164 1165 1166 1163 1164 1165 1166 1163 1164 1165 1166 1163 1164 1165 1166 1163 1164 1165 1166 1163 1164 1165 1166 1163 1164 1165 1166 1163 1164 1165 1166 1163 1164 1165 1166 1163 1164 1165 1166 1163 1164 1165 1166 1163 1164 1165 1166 1163 1164 1165 1166 1163 1164 1165 1166 1163 1164 1165 1166 1163 1164 1165 1166 1163 1164 1165 1166 1163 1164 1165 1166 1163 1164 1165 1166 1163 1164 1165 1166 1163
1227 1228 1229 1230 1227 1228 1229 1230 1227 1228 1229 1230 1227 1228 1229 1230 1227 1228 1229 1230 1227 1228 1229 1230 1227 1228 1229 1230 1227 1228 1229 1230 1227 1228 1229 1230 1227 1228 1229 1230 1227 1228 1229 1230 1227 1228 1229 1230 1227 1228 1229 1230 1227 1228 1229 1230 1227 1228 1229 1230 1227 1228 1229 1230 1227 1228 1229 1230 1227 1228 1229 1230 1227 1228 1229 1230 1227 1228 1229 1230 1227 1228 1229 1230 1227
1291 1292 1293 1294 1291 1292 1293 1294 1291 1292 1293 1294 1291 1292 1293 1294 1291 1292 1293 1294 1291 1292 1293 1294 1291 1292 1293 1294 1291 1292 1293 1294 1291 1292 1293 1294 1291 1292 1293 1294 1291 1292 1293 1294 65 65 65 65 65 65 65 65 65 65 65 65 65 65 65 65 65 65 65 65 65 65 1985 65 65 65 65 65 65 1292 1293 1294 1291 1292 1293 1294 1291 1292 1293 1294 1291
1355 1356 1357 1358 1355 1356 1357 1358 1355 1356 1357 1358 1355 1356 1357 1358 1355 1356 1357 1358 1355 1356 1357 1358 1355 1356 1357 1358 1355 1356 1357 1358 1355 65 65 65 65 65 65 65 65 65 65 65 65 65 65 65 65 65 65 65 65 65 65 65 65 65 65 65 65 65 65 65 65 65 1985 1986 1987 65 65 65 65 65 65 65 65 1356 1357 1358 1355 1356 1357 1358 1355
1163 1164 1165 1166 1163 1164 1165 1166 1163 1164 1165 1166 1163 1164 1165 1166 1163 1164 1165 1166 1163 1164 1165 1166 1163 1164 1165 1166 65 65 65 65 65 65 65 65 65 65 65 65 65 65 65 65 65 65 65 65 65 65 65 65 65 65 65 65 65 65 65 65 65 65 65 65 65 65 1985 1986 1987 67 67 65 65 65 65 65 65 65 1165 1166 1163 1164 1165 1166 1163
1227 1228 1229 1230 1227 1228 1229 1230 1227 1228 1229 1230 1227 1228 1229 1230 1227 1228 1229 1230 1227 1228 1229 1230 1227 1228 65 65 65 65 65 65 65 65 65 65 65 65 65 65 65 65 65 65 65 65 65 65 65 65 65 65 65 65 65 65 65 65 65 65 65 65 65 65 65 65 1985 1986 1987 67 67 67 67 67 67 67 65 65 65 1230 1227 1228 1229 1230 1227
1291 1292 1293 1294 1291 1292 1293 1294 1291 1292 1293 1294 1291 1292 1293 1294 1291 1292 1293 1294 1291 1292 1293 65 65 65 65 65 65 65 65 65 65 65 65 65 65 65 65 65 65 65 65 65 65 65 65 65 65 65 65 65 65 65 65 65 65 65 65 65 65 65 65 65 65 65 1985 1986 1987 67 67 67 67 67 67 67 67 65 65 1294 1291 1292 1293 1294 1291
1355 1356 1357 1358 1355 1356 1357 1358 1355 1356 1357 1358 1355 1356 1357 1358 1355 1356 1357 65 65 65 65 65 65 65 65 65 65 65 65 65 65 65 65 65 65 65 65 65 65 65 65 65 65 65 65 65 65 65 65 65 65 65 65 65 65 65 65 65 65 65 65 1985 65 1985 266 67 67 67 67 67 67 67 67 67 67 65 65 1358 1355 1356 1357 1358 1355
1163 1164 1165 1166 1163 1164 1165 1166 1163 1164 1165 1166 1163 1164 1165 1166 1163 65 65 65 65 65 65 65 65 65 65 65 65 65 65 65 65 65 65 65 65 65 65 65 65 65 65 65 65 65 65 65 65 65 65 65 65 65 65 65 65 65 65 65 65 65 65 1985 1986 1987 67 67 67 67 67 67 67 67 67 67 67 65 65 1166 1163 1164 1165 1166 1163
1227 1228 1229 1230 1227 1228 1229 1230 1227 1228 1229 1230 1227 1228 1229 1230 65 65 65 65 65 65 65 65 65 65 65 65 65 65 65 65 65 65 65 65 65 65 65 65 65 65 65 65 65 65 65 65 65 65 65 65 65 65 65 65 65 65 65 65 66 65 65 266 449 449 67 67 67 67 67 67 67 67 67 67 67 65 65 1230 1227 1228 1229 1230 1227
1291 1292 1293 1294 1291 1292 1293 1294 1291 1292 1293 1294 1291 1292 65 65 65 65 65 65 65 65 65 65 65 65 65 65 65 65 65 65 65 65 65 65 65 65 65 65 65 65 65 65 65 65 65 65 65 65 65 65 65 65 65 65 65 1985 65 1985 66 66 66 266 67 67 67 67 67 67 67 67 67 67 67 67 67 65 65 1294 1291 1292 1293 1294 1291
1355 1356 1357 1358 1355 1356 1357 1358 1355 1356 1357 1358 65 65 65 65 65 65 65 65 65 65 65 65 65 65 65 65 65 65 65 65 65 65 65 65 65 65 65 65 65 65 65 65 65 65 65 65 65 65 65 65 65 65 65 66 66 1985 1986 1987 1985 65 1985 266 67 67 67 67 67 67 67 67 67 67 67 67 67 65 65 1358 1355 1356 1357 1358 1355
1163 1164 1165 1166 1163 1164 1165 1166 1163 1164 1985 65 65 65 65 65 65 65 65 65 65 65 65 65 65 65 65 65 65 65 65 65 65 65 65 65 65 65 65 65 65 65 65 65 65 65 65 65 65 65 65 66 66 66 66 66 66 266 449 266 1985 1986 1987 266 67 67 67 67 67 67 67 67 67 67 67 65 65 65 65 1166 1163 1164 1165 1166 1163
1227 1228 1229 1230 1227 1228 1229 1230 66 66 1985 1985 65 65 65 65 65 65 65 65 65 65 65 65 65 65 65 65 65 65 65 65 65 65 65 65 65 65 65 65 65 65 65 65 65 65 65 65 65 65 65 1985 65 1985 1985 65 1985 266 67 67 449 449 449 67 67 67 67 67 67 65 65 65 65 65 65 65 65 65 1229 1230 1227 1228 1229 1230 1227
1291 1292 1293 1294 1291 1292 1293 66 66 66 1985 1985 1985 65 1985 65 65 65 65 65 65 1985 65 1985 1985 65 1985 65 65 65 65 65 65 65 65 65 65 65 65 65 65 65 65 65 65 65 66 65 66 66 66 1985 1986 1987 1985 1986 1987 266 67 67 67 67 67 67 65 65 65 65 65 65 65 65 65 65 65 65 65 1292 1293 1294 1291 1292 1293 1294 1291
1355 1356 1357 1358 1355 1356 66 66 66 66 67 67 1985 1986 1987 65 65 65 65 65 65 1985 1986 1987 1985 1986 1987 65 65 65 65 65 65 65 65 65 65 65 65 65 65 65 65 65 65 65 66 65 1985 65 1985 449 449 449 449 449 449 67 67 67 67 67 67 67 65 65 65 65 65 65 1357 1358 1355 1356 1357 1358 1355 1356 1357 1358 1355 1356 1357 1358 1355
1163 1164 1165 1166 1163 1164 66 66 66 67 67 67 449 449 266 1985 65 1985 66 65 66 266 449 449 449 449 266 65 65 65 65 65 65 65 65 65 65 65 65 65 65 65 65 65 65 65 66 66 1985 1986 1987 67 67 67 67 67 67 67 67 67 67 67 67 67 65 65 1165 1166 1163 1164 1165 1166 1163 1164 1165 1166 1163 1164 1165 1166 1163 1164 1165 1166 1163
1227 1228 1229 1230 1227 66 66 66 67 67 67 67 67 67 266 1985 1986 1987 1985 65 1985 266 67 67 67 67 266 1985 65 1985 1985 65 1985 65 65 65 67 67 67 67 67 67 67 67 67 1985 65 1985 449 449 449 67 67 67 67 67 67 67 67 67 67 67 67 67 65 65 65 1230 1227 1228 1229 1230 1227 1228 1229 1230 1227 1228 1229 1230 1227 1228 1229 1230 1227
1291 1292 1293 1294 66 66 66 67 67 67 67 67 67 67 67 449 449 266 1985 1986 1987 266 67 67 67 67 266 1985 1986 1987 1985 1986 1987 65 65 65 67 67 67 67 67 67 67 67 67 1985 1986 1987 67 67 67 67 67 67 67 67 67 67 67 67 67 67 67 67 65 65 65 1294 1291 1292 1293 1294 1291 1292 1293 1294 1291 1292 1293 1294 1291 1292 1293 1294 1291
1355 1356 1357 1358 66 66 67 67 67 67 67 67 67 67 67 67 67 67 449 449 449 67 67 67 67 67 67 449 449 449 449 449 266 1985 65 1985 67 67 67 67 67 67 67 67 67 1985 449 449 67 67 67 67 67 67 67 67 67 67 67 67 67 67 67 67 67 65 65 65 1355 1356 1357 1358 1355 1356 1357 1358 1355 1356 1357 1358 1355 1356 1357 1358 1358
1163 1164 1165 66 66 66 67 67 67 67 67 67 67 67 67 67 67 67 67 67 67 67 67 67 67 67 67 67 67 67 67 67 266 1985 1986 1987 67 67 67 468 469 67 67 67 67 67 67 67 67 67 67 67 67 67 67 67 67 67 67 67 67 67 67 67 67 65 65 65 65 65 1165 1166 1163 1164 1165 1166 1163 1164 1165 1166 1163 1164 1165 1166 1163
1227 1228 1229 66 66 67 67 67 67 67 67 67 67 67 67 67 67 67 67 67 67 67 67 67 67 67 67 67 67 67 67 67 67 449 449 449 67 67 67 468 469 67 67 67 67 67 67 67 67 67 67 67 67 67 67 67 67 67 67 67 67 67 67 67 67 67 67 65 65 65 65 1230 1227 1228 1229 1230 1227 1228 1229 1230 1227 1228 1229 1230 1227
1291 1292 66 66 67 67 67 67 67 67 67 67 67 67 67 67 67 67 67 67 67 67 67 67 67 67 67 67 67 67 67 67 67 67 67 67 67 67 67 468 469 67 67 67 67 67 67 67 67 67 67 67 67 67 67 67 67 67 67 67 67 67 67 67 67 67 67 67 67 65 65 65 65 1292 1293 1294 1291 1292 1293 1294 1291 1292 1293 1294 1291
1355 1356 66 66 67 67 67 67 67 67 67 67 67 67 67 67 67 67 67 67 67 67 67 67 67 67 67 67 67 67 67 67 67 67 67 67 67 67 67 468 469 67 67 67 67 67 67 67 67 67 67 67 67 67 67 67 67 67 67 67 67 67 67 67 67 67 67 67 67 67 67 65 65 65 1357 1358 1355 1356 1357 1358 1355 1356 1357 1358 1355
1163 1164 66 66 67 67 67 67 67 67 67 67 67 67 67 67 67 67 67 67 67 67 67 67 67 67 67 67 67 67 67 67 67 67 67 67 67 67 67 468 469 67 67 67 67 67 67 67 67 67 67 67 67 67 67 67 67 67 67 67 67 67 67 67 67 67 67 67 67 67 67 67 65 65 65 1166 1163 1164 1165 1166 1163 1164 1165 1166 1163
1227 1228 66 66 67 67 67 67 67 67 67 67 67 67 67 67 67 67 67 468 468 468 468 468 468 468 468 468 468 468 468 468 468 468 468 468 468 468 469 468 469 67 67 67 67 67 67 67 67 67 67 67 67 67 67 67 67 67 67 67 67 67 67 67 67 67 67 67 67 67 67 67 67 65 65 1230 1227 1228 1229 1230 1227 1228 1229 1230 1227
1291 1292 66 66 67 67 67 67 67 67 67 67 67 67 67 67 67 67 67 532 532 532 532 532 532 532 532 532 532 532 532 532 532 532 532 532 532 532 533 532 533 67 67 67 67 67 67 67 67 67 67 67 67 67 67 67 67 67 67 67 67 67 67 67 67 67 67 67 67 67 67 67 67 65 65 1294 1291 1292 1293 1294 1291 1292 1293 1294 1291
1355 1356 66 66 67 67 67 67 67 67 67 67 468 469 469 469 469 469 469 469 469 67 67 67 67 67 67 67 67 67 67 67 67 67 67 67 67 67 67 67 67 67 67 67 67 67 67 67 67 67 67 67 67 67 67 67 67 67 67 67 67 67 67 67 67 67 67 67 67 67 67 67 67 65 65 1358 1355 1356 1357 1358 1355 1356 1357 1358 1355
65 65 66 66 67 67 67 67 67 67 67 67 468 469 533 533 533 533 533 533 533 67 67 67 67 67 67 67 67 67 67 67 67 67 67 67 67 67 67 67 67 67 67 67 67 67 67 67 67 67 67 67 67 67 67 67 67 67 67 67 67 67 67 67 67 67 67 67 67 67 67 67 67 65 65 1166 1163 1164 1165 1166 1163 1164 1165 1166 1163
65 65 66 66 66 66 67 67 67 67 67 67 468 469 67 67 67 67 67 67 67 67 67 67 67 67 67 67 67 67 67 67 67 67 67 67 67 67 67 67 67 67 67 67 67 67 67 67 67 67 67 67 67 67 67 67 67 67 67 67 67 67 67 67 67 67 67 67 67 67 67 67 67 65 65 65 1227 1228 1229 1230 1227 1228 1229 1230 1227
65 65 65 65 65 66 67 67 67 67 67 67 468 469 67 67 67 67 67 67 67 67 67 67 67 67 67 67 67 67 67 67 67 67 67 67 67 67 67 67 67 67 67 67 67 67 67 67 67 67 67 67 67 67 67 67 67 67 67 67 67 67 67 67 67 67 67 67 67 67 67 67 67 65 65 65 1291 1292 1293 1294 1291 1292 1293 1294 1291
65 65 65 65 65 66 66 66 67 67 67 67 532 533 67 67 67 67 67 67 67 67 67 67 67 67 67 67 67 67 67 67 67 67 67 67 67 67 67 67 67 67 67 67 67 67 67 67 67 67 67 67 67 67 67 67 67 67 67 67 67 67 67 67 67 67 67 67 67 67 67 67 67 67 65 65 1355 1356 1357 1358 1355 1356 1357 1358 1355
65 65 65 65 65 65 66 66 66 67 67 67 67 67 67 67 67 67 67 67 67 67 67 67 67 67 67 67 67 67 67 67 67 67 67 67 67 67 67 67 67 67 67 67 67 67 67 67 67 67 67 67 67 67 67 67 67 67 67 67 67 67 67 67 67 67 67 67 67 67 67 67 67 67 65 65 1163 1164 1165 1166 1163 1164 1165 1166 1163
65 65 65 65 65 65 65 65 66 66 66 67 67 67 67 67 67 67 67 67 67 67 67 67 67 67 67 67 67 67 67 67 67 67 67 67 67 67 67 67 67 67 67 67 67 67 67 67 67 67 67 67 67 67 67 67 67 67 67 67 67 67 67 67 67 67 67 67 67 67 67 67 65 65 65 65 1227 1228 1229 1230 1227 1228 1229 1230 1227
65 65 65 65 65 65 65 65 65 65 65 65 65 65 65 65 65 65 65 67 67 67 67 67 67 67 67 67 67 67 67 67 67 67 67 67 67 67 67 67 67 67 67 67 67 67 67 67 67 67 67 67 67 67 67 67 67 67 67 67 67 67 67 67 67 67 67 65 65 65 65 65 65 65 65 65 1291 1292 1293 1294 1291 1292 1293 1294 1291
1987 65 65 65 1985 65 1985 65 65 65 65 66 66 65 65 65 65 65 65 65 65 65 65 65 65 65 65 65 65 65 65 65 65 65 65 65 65 65 65 65 65 65 65 65 65 65 65 65 65 65 65 65 65 65 65 65 65 65 67 67 67 65 65 65 65 65 65 65 65 65 65 65 65 1985 65 1985 1355 1356 1357 1358 1355 1356 1357 1358 1355
1987 65 65 65 1985 1986 1987 1985 65 1985 1985 65 1985 66 65 65 65 65 65 65 65 65 65 65 65 65 65 65 65 65 65 65 65 65 65 65 65 65 65 65 65 65 65 65 65 65 65 65 65 65 65 65 65 65 65 65 65 65 65 65 65 65 65 65 65 65 65 1985 65 1985 65 65 65 1985 1986 1987 1163 1164 1165 1166 1163 1164 1165 1166 1163
1987 1985 65 1985 1985 1986 1987 1985 1986 1987 1985 1986 1987 65 65 65 65 65 65 1985 65 1985 1985 65 1985 1985 65 1985 65 65 65 65 65 65 65 65 65 65 65 1985 65 65 65 65 65 65 65 65 1985 65 65 65 65 65 65 65 65 65 65 65 65 1985 65 1985 1985 65 1985 1985 1986 1987 65 65 65 1985 1986 1987 1227 1228 1229 1230 1227 1228 1229 1230 1227
1987 1985 1986 1987 1985 1986 1987 1985 1986 1987 1985 1986 1987 1985 65 1985 1985 65 1985 1985 1986 1987 1985 1986 1987 1985 1986 1987 65 65 65 65 65 65 65 65 1985 1985 1986 1987 1985 65 1985 1985 65 1985 1985 1986 1987 65 65 65 65 65 65 65 65 65 1985 65 1985 1985 1986 1987 1985 1986 1987 1985 1986 1987 1985 65 1985 1985 1986 1987 1291 1292 1293 1294 1291 1292 1293 1294 1291
1987 1985 1986 1987 1985 1986 1987 1985 1986 1987 1985 1986 1987 1985 1986 1987 1985 1986 1987 1985 1986 1987 1985 1986 1987 1985 1986 1987 1985 65 1985 1985 65 1985 1985 1986 1987 1985 1986 1987 1985 1986 1987 1985 1986 1987 1985 1986 1987 1985 65 1985 1985 65 1985 1985 65 1985 1985 1986 1987 1985 1986 1987 1985 1986 1987 1985 1986 1987 1985 1986 1987 1985 1986 1987 1355 1356 1357 1358 1355 1356 1357 1358 1355