66 66 66 66 468 468 468 468 468 468 468 468 468 468 66 66 66 66 66 66 66 66 66 66 66 66 66 66 66 66 66 66 66 66 66 66 1921 1922 1923 66 66 66 66 66 66 66 66 66 1921 1922 1923 66 66 66 66 66 66 66 66 66
66 66 468 468 468 468 468 468 468 468 468 468 468 468 468 468 66 66 66 66 66 66 66 66 66 66 66 66 66 66 66 66 66 66 66 66 1985 1986 1987 66 66 66 66 66 66 1921 1922 1923 1985 1986 1987 66 66 66 66 66 66 66 66 66
66 468 468 468 468 468 468 468 468 468 468 468 468 468 468 468 468 468 66 66 66 66 66 66 66 66 66 66 66 66 66 66 66 66 66 66 1985 1986 1987 1921 1922 1923 1921 1922 1923 1985 1986 1987 1985 1986 1987 66 66 66 66 66 66 66 66 66
468 468 468 468 468 468 468 468 468 468 468 468 468 468 468 468 468 468 66 66 66 66 66 66 66 66 66 66 66 66 66 66 66 66 66 66 1985 1986 1987 1985 1986 1987 1985 1986 1987 1985 1986 1987 1985 1986 1987 66 66 66 66 66 66 66 66 66
468 468 468 468 468 468 468 468 468 468 468 468 468 468 468 468 468 468 468 66 66 66 66 66 66 66 66 66 66 66 66 66 66 66 66 66 394 1986 1985 1985 1986 1987 1985 1986 1987 1985 1986 1987 1985 1986 396 66 66 66 66 66 66 66 66 66
468 468 468 468 468 468 468 468 468 468 468 468 468 468 468 468 468 468 468 66 66 66 66 66 66 66 66 66 66 66 66 66 66 66 66 66 66 66 66 1985 1986 1987 1985 1986 1987 394 1986 396 66 66 66 66 66 66 66 66 66 66 66 66
468 468 468 468 468 468 468 468 468 468 468 468 468 468 468 468 468 468 468 66 66 66 66 66 66 66 66 66 66 66 66 66 66 66 66 66 66 66 66 394 1986 396 394 1986 396 66 66 66 66 66 66 66 66 66 66 66 66 66 66 66
468 468 468 468 468 468 468 468 468 468 468 468 468 468 468 468 468 468 468 468 66 66 66 66 66 66 66 66 66 66 66 66 66 66 66 66 66 468 468 468 468 468 66 66 66 66 66 66 66 66 66 66 66 66 66 66 66 66 66 66
468 468 468 468 468 468 468 468 468 468 468 468 468 468 468 468 468 468 468 468 66 66 66 66 66 66 66 66 66 66 66 66 66 66 66 468 468 468 468 468 66 66 66 66 66 66 66 66 66 66 66 66 66 66 66 66 66 66 66 66
66 468 468 468 468 468 468 468 468 468 468 468 468 468 468 468 468 468 468 468 66 66 66 66 66 66 66 66 66 66 66 66 66 66 468 468 468 468 66 66 66 66 66 66 66 66 66 66 66 66 66 66 66 66 66 66 66 66 66 66
66 468 468 468 468 468 468 468 468 468 468 468 468 468 468 468 468 468 468 66 66 66 66 66 66 66 66 66 66 66 66 66 66 468 468 468 66 66 66 66 66 66 66 66 66 66 66 66 66 66 66 66 66 66 66 66 66 66 66 66
66 66 66 468 468 468 468 468 468 468 468 468 468 468 468 468 468 468 66 66 66 66 66 66 66 66 66 66 66 66 66 66 468 468 468 66 66 66 66 66 66 66 66 66 66 66 66 66 66 66 66 66 66 66 66 66 66 66 66 66
66 66 66 66 66 468 468 468 468 468 468 468 468 468 468 468 66 66 66 66 66 66 66 66 66 66 66 66 66 66 468 468 468 468 66 66 66 66 66 66 66 66 66 66 66 66 66 66 66 66 66 66 66 66 66 66 66 66 66 66
66 66 66 66 66 66 66 66 66 66 66 66 66 66 468 468 66 66 66 66 66 66 66 66 66 66 66 66 66 468 468 468 66 66 66 66 66 66 66 66 66 66 66 66 66 66 66 66 66 66 66 66 66 66 66 66 66 66 66 66
66 66 66 66 66 66 66 66 66 66 66 66 66 66 468 468 66 66 66 66 66 66 66 66 66 66 66 468 468 468 468 66 66 66 66 66 66 66 66 66 66 66 66 66 66 66 66 66 66 66 66 66 66 66 66 66 66 66 66 66
66 66 66 66 66 66 66 66 66 66 66 66 66 66 468 468 66 66 66 66 66 66 66 66 66 66 468 468 468 468 66 66 66 66 66 66 66 66 66 66 66 66 66 66 66 66 66 66 66 66 66 66 66 66 66 66 66 66 66 66
66 66 66 66 66 66 66 66 66 66 66 66 66 66 468 468 468 66 66 66 66 66 66 66 468 468 468 468 66 66 66 66 66 66 66 66 66 66 66 66 66 66 66 66 66 66 66 66 66 66 66 66 66 66 66 66 66 66 66 66
66 66 66 66 66 66 66 66 66 66 66 66 66 66 66 468 468 66 66 66 66 66 66 468 468 468 66 66 66 66 66 66 66 66 66 66 66 66 66 66 66 66 66 66 66 66 66 66 66 66 66 66 66 66 66 66 66 66 66 66
66 66 66 66 66 66 66 66 66 66 66 66 66 66 66 468 468 66 66 66 66 468 468 468 468 66 66 66 66 66 66 66 66 66 66 66 66 66 66 66 66 66 66 66 66 66 66 66 66 66 66 66 66 66 66 66 66 66 66 66
66 66 66 66 66 66 66 66 66 66 66 66 66 66 66 468 468 66 66 66 66 468 468 468 66 66 66 66 66 66 66 66 66 66 66 66 66 66 66 66 66 66 66 66 468 468 468 468 468 468 468 468 468 468 66 66 66 66 66 66
66 66 66 66 66 66 66 66 66 66 66 66 66 66 66 468 468 468 66 66 66 468 468 66 66 66 66 66 66 66 66 66 66 66 66 66 66 66 66 66 66 66 468 468 468 468 468 468 468 468 468 468 468 468 468 468 66 66 66 66
66 66 66 66 66 66 66 66 66 66 66 66 66 66 66 66 468 468 66 66 66 468 468 66 66 66 66 66 66 66 66 66 66 66 66 66 66 66 66 66 66 468 468 468 468 468 468 468 468 468 468 468 468 468 468 468 468 468 66 66
66 66 66 66 66 66 66 66 66 66 66 66 66 66 66 66 468 468 468 66 66 468 468 66 66 66 66 66 66 66 66 66 66 66 66 66 66 66 468 468 468 468 468 468 468 468 468 468 468 468 468 468 468 468 468 468 468 468 66 66
66 66 66 66 66 66 66 66 66 66 66 66 66 66 66 66 66 468 468 468 66 468 468 66 66 66 66 66 66 66 66 66 66 66 66 468 468 468 468 468 468 468 468 468 468 468 468 468 468 468 468 468 468 468 468 468 468 468 468 66
66 66 66 66 66 66 66 66 66 66 66 66 66 66 66 66 66 468 468 468 468 468 468 66 66 66 66 66 66 66 66 468 468 468 468 468 468 468 468 468 468 468 468 468 468 468 468 468 468 468 468 468 468 468 468 468 468 468 468 66
66 66 66 66 66 66 66 66 66 66 66 66 66 66 66 66 66 66 66 468 468 468 468 66 468 468 468 468 468 468 468 468 468 468 468 468 468 66 66 66 468 468 468 468 468 468 468 468 468 468 468 468 468 468 468 468 468 468 468 66
66 66 66 66 66 66 66 66 66 66 66 66 66 66 66 66 66 66 66 66 468 468 468 468 468 468 468 468 468 468 468 468 468 66 66 66 66 66 66 66 468 468 468 468 468 468 468 468 468 468 468 468 468 468 468 468 468 468 468 468
66 66 66 66 66 66 66 66 66 66 66 66 66 66 66 66 66 66 66 66 66 468 468 468 468 468 66 66 66 66 66 66 66 66 66 66 66 66 66 66 468 468 468 468 468 468 468 468 468 468 468 468 468 468 468 468 468 468 468 468
66 66 66 66 66 66 66 66 66 66 66 66 66 468 468 468 468 468 468 468 468 468 66 66 66 66 66 66 66 66 66 66 66 66 66 66 66 66 66 66 66 468 468 468 468 468 468 468 468 468 468 468 468 468 468 468 468 468 468 468
66 66 66 66 66 66 66 66 66 66 66 66 66 468 468 468 468 468 468 468 468 468 66 66 66 66 66 66 66 66 66 66 66 66 66 66 66 66 66 66 66 468 468 468 468 468 468 468 468 468 468 468 468 468 468 468 468 468 468 66
66 66 66 468 468 468 468 468 468 468 468 468 468 468 468 468 66 66 66 66 66 66 66 66 66 66 66 66 66 66 66 66 66 66 66 66 66 66 66 66 66 66 66 468 468 468 468 468 468 468 468 468 468 468 468 468 468 468 66 66
66 66 468 468 468 468 468 468 468 468 468 468 468 468 468 468 66 66 66 66 66 66 66 66 66 66 66 66 66 66 66 66 66 66 66 66 66 66 66 66 66 66 66 66 66 468 468 468 468 468 468 468 468 468 468 66 66 66 66 66
66 468 468 468 468 468 468 468 468 468 468 468 468 468 468 468 66 66 66 66 66 66 66 66 66 66 66 66 66 66 66 66 66 66 66 66 66 66 66 66 66 66 66 66 66 66 66 66 66 66 66 66 66 66 66 66 66 66 66 66
468 468 468 468 468 468 468 468 468 468 468 468 468 468 468 468 66 66 66 66 66 66 66 66 66 66 66 66 66 66 66 66 66 66 66 66 66 66 66 66 66 66 66 66 66 66 66 66 66 66 66 66 66 66 66 66 66 66 66 66
468 468 468 468 468 468 468 468 468 468 468 468 468 468 468 468 66 66 66 66 66 66 66 66 66 66 66 66 66 66 66 66 66 66 66 66 66 66 66 66 66 66 66 66 66 66 66 66 66 66 66 66 66 66 66 66 66 66 66 66
468 468 468 468 468 468 468 468 468 468 468 468 468 468 468 468 468 66 66 66 66 66 66 66 66 66 66 66 66 66 66 66 66 66 66 66 66 66 66 66 66 66 66 66 66 66 66 66 66 66 66 66 66 66 66 66 66 66 66 66
468 468 468 468 468 468 468 468 468 468 468 468 468 468 468 468 468 468 468 66 66 66 66 66 66 66 66 66 66 66 66 66 66 66 66 66 66 66 66 66 66 66 66 66 66 66 66 66 66 66 66 66 66 66 66 66 66 66 66 66
468 468 468 468 468 468 468 468 468 468 468 468 468 468 468 468 468 468 468 66 66 66 66 66 66 66 66 66 66 66 66 66 66 66 66 66 66 66 66 66 66 66 66 66 66 66 66 66 66 66 66 66 66 66 66 66 66 66 66 66
468 468 468 468 468 468 468 468 468 468 468 468 468 468 468 468 468 468 468 468 66 66 66 66 66 66 66 66 66 66 66 66 66 66 66 66 66 66 66 66 66 66 66 66 66 66 66 66 66 66 66 66 66 66 66 66 66 66 66 66
66 468 468 468 468 468 468 468 468 468 468 468 468 468 468 468 468 468 66 66 66 66 66 66 66 66 66 66 66 66 66 66 66 66 66 66 66 66 66 66 66 66 66 66 66 66 66 66 66 66 66 66 66 66 66 66 66 66 66 66
66 468 468 468 468 468 468 468 468 468 468 468 468 468 468 468 468 468 66 66 66 66 66 66 66 66 66 66 66 66 66 66 66 66 66 66 66 66 66 66 66 66 66 66 66 66 66 66 66 66 66 66 66 66 66 66 66 66 66 66
66 66 468 468 468 468 468 468 468 468 468 468 468 468 468 468 468 468 66 66 66 66 66 66 66 66 66 66 66 66 66 66 66 66 66 66 66 66 66 66 66 66 66 66 66 66 66 66 66 66 66 66 66 66 66 66 66 66 66 66
66 66 66 66 468 468 468 468 468 468 468 468 468 468 468 468 66 66 66 66 66 66 66 66 66 66 66 66 66 66 66 66 66 66 66 66 66 66 66 66 66 66 66 66 66 66 66 66 66 66 66 66 66 66 66 66 66 66 66 66
66 66 66 66 66 66 66 66 66 66 66 66 66 66 66 66 66 66 66 66 66 66 66 66 66 66 66 66 66 66 66 66 66 66 66 66 66 66 66 66 66 66 66 66 66 66 66 66 66 66 66 66 66 66 66 66 66 66 66 66
66 66 66 66 66 66 66 66 66 66 66 66 66 66 66 66 66 66 66 66 66 66 66 66 66 66 66 66 66 66 66 66 66 66 66 66 66 66 66 66 66 66 66 66 66 66 66 66 66 66 66 66 66 66 66 66 66 66 66 66
