0 1 2 0 1 2 0 1 2 0 1 2 0 1 2 0 1 2 0 1 2 0 1 2 0 1 2 0 1 2 0 1 2 0 1 2 0 1 2 0 1 2 0 1 2 0 1 2 0 1 2 0 1 2 0 1 2 0 1 2 0 1 2 0 1 2 0 1 2 0 1 2 0 1 2 0 1 2 0 1 2 0 1 2 0
85 86 87 85 86 87 85 86 87 85 86 87 85 86 87 85 86 87 85 86 87 85 86 87 85 86 87 85 86 87 85 86 87 85 86 87 85 86 87 85 86 87 85 86 87 85 86 87 85 86 87 85 86 87 85 86 87 85 86 87 85 86 87 85 86 87 85 86 87 85 86 87 85 86 87 85 86 87 85 86 87 85 86 87 85
170 171 172 170 171 172 170 171 172 170 171 172 170 171 172 170 171 172 170 171 172 170 171 172 170 171 172 170 171 172 170 171 172 170 171 172 170 171 172 170 171 172 170 171 172 170 171 172 170 171 172 170 171 172 170 171 172 170 171 172 170 171 172 170 171 172 170 171 172 170 171 172 170 171 172 170 171 172 170 171 172 170 171 172 170
0 1 2 0 1 2 0 1 2 0 1 2 0 1 2 0 1 2 0 1 2 0 1 2 0 1 2 0 1 2 0 1 2 0 1 2 0 1 2 0 1 2 0 1 2 0 1 2 0 1 2 0 1 2 0 1 481 482 483 484 485 486 487 488 1 2 0 1 2 0 1 2 0 1 2 0 1 2 0 1 2 0 1 2 0
85 86 87 85 86 87 85 86 87 85 86 87 85 86 87 85 86 87 85 86 87 85 86 87 85 86 87 85 86 87 85 86 87 85 86 87 85 86 87 85 86 87 85 86 87 85 86 87 85 86 87 85 86 87 85 86 566 567 568 569 570 571 572 573 86 87 85 86 87 85 86 87 85 86 87 85 86 87 85 86 87 85 86 87 85
170 171 172 170 171 172 170 171 172 170 171 172 170 171 172 170 171 172 170 171 172 170 171 172 170 171 172 170 171 172 170 171 172 170 171 172 170 171 172 170 171 172 170 171 172 170 171 172 170 171 172 170 171 172 170 171 651 652 653 654 655 656 657 658 171 172 170 171 172 170 171 172 170 171 172 170 171 172 170 171 172 170 171 172 170
0 1 2 0 1 2 0 1 2 0 1 2 0 1 2 0 1 2 0 1 2 0 1 2 0 1 2 0 1 2 0 1 2 0 1 2 0 1 2 0 1 2 0 1 2 0 1 2 0 1 1037 1037 1037 1037 1037 1037 736 737 738 739 740 741 742 743 1 2 0 1 2 0 1 2 0 1 2 0 1 2 0 1 2 0 1 2 0
85 86 87 85 86 87 85 86 87 85 86 87 85 86 87 85 86 87 85 86 87 85 86 87 85 86 87 85 86 87 85 86 87 85 86 87 85 86 87 85 1037 1037 1037 1037 1037 1144 1145 1146 1037 1037 1037 1037 1037 1037 1037 1037 821 822 823 824 825 826 827 828 1037 1037 1037 1037 1037 1037 1037 1037 1037 86 87 85 86 87 85 86 87 85 86 87 85
170 171 172 170 171 172 170 171 172 170 171 172 170 171 172 170 171 172 170 171 172 170 171 172 170 171 172 170 171 172 170 171 1037 1037 1037 1037 1037 1037 1037 1037 1037 1037 1037 1227 1228 1229 1230 1231 1232 1233 1037 1037 1037 1037 1037 1037 906 907 908 909 910 911 912 913 1037 1037 1037 1037 1037 1037 1037 1037 1037 1037 1037 170 171 172 170 171 172 170 171 172 170
0 1 2 0 1 2 0 1 2 0 1 2 0 1 2 0 1 2 0 1 2 0 1 2 0 1 2 0 1 1037 1037 1037 1037 1037 1037 1037 1037 1037 1037 1037 1037 1310 1311 1312 1313 1314 1315 1316 1317 1318 1319 1320 1037 1037 1037 1037 991 992 993 994 995 996 997 1037 1037 1037 1037 1037 1037 1037 1037 1037 1370 1037 1544 1037 1037 2 0 1 2 0 1 2 0
85 86 87 85 86 87 85 86 87 85 86 87 85 86 87 85 86 87 85 86 87 85 86 87 85 86 87 1037 1037 1037 1037 1037 1037 1037 1037 1037 1037 1037 1037 1037 1037 1565 1315 1315 1315 1315 1315 1315 1315 1315 1315 1575 1037 1037 1037 1037 1076 1077 1078 1079 1080 1081 1082 1037 1037 1037 1037 1037 1037 1037 1037 1037 1455 1628 1455 2051 1037 1037 85 86 87 85 86 87 85
170 171 172 170 171 172 170 171 172 170 171 172 170 171 172 170 171 172 170 171 172 170 171 172 1037 1037 1037 1037 1037 1037 1037 1037 1037 1037 1037 1037 1037 1037 1037 1037 1037 1565 1315 1315 1315 1484 1485 1486 1315 1315 1315 1575 1037 1037 1037 1037 1161 1162 1163 1164 1165 1166 1167 1370 1037 1544 1037 1037 1037 1370 1037 1544 1712 1628 1975 2051 2051 1037 1037 171 172 170 171 172 170
0 1 2 0 1 2 0 1 2 0 1 2 0 1 2 0 1 2 0 1 2 0 1037 1037 1037 1037 1037 1037 1037 1037 1037 1037 1037 1037 1037 1037 1037 1037 1037 1037 1037 1565 1317 1567 1568 1569 1570 1571 1572 1573 1317 1575 1037 1037 1037 1037 1037 1037 1037 1037 1037 1037 1037 1455 1628 1455 1370 1037 1544 1455 1628 1455 2051 2051 2051 2051 2051 2051 1037 1 2 0 1 2 0
85 86 87 85 86 87 85 86 87 85 86 87 85 86 87 85 86 87 85 1037 1037 1037 1037 1037 1037 1037 1037 1037 1037 1037 1037 1037 1037 1037 1037 1037 1037 1037 1037 1037 1037 1650 1651 1652 1570 1570 1570 1570 1570 1658 1659 1660 1037 1037 1037 1037 1037 1370 1037 1544 1370 1037 1544 1712 1628 1975 1455 1628 1455 1712 1628 1975 2051 2051 2051 2051 2051 2051 1037 86 87 85 86 87 85
170 171 172 170 171 172 170 171 172 170 171 172 170 171 172 170 171 172 1037 1037 1037 1037 1037 1037 1037 1037 1037 1037 1037 1037 1037 1037 1037 1037 1037 1037 1037 1037 1037 1037 1037 1905 1570 1570 1570 1570 1570 1570 1570 1570 1570 1745 1037 1037 1370 1037 1544 1455 1628 1455 1455 1628 1455 2051 2051 2051 1712 1628 918 919 2051 2051 2051 2051 2051 2051 2051 2051 1037 171 172 170 171 172 170
0 1 2 0 1 2 0 1 2 0 1 2 0 1 2 0 1 1037 1037 1037 1037 1037 1037 1037 1037 1037 1037 1037 1037 1037 1037 1037 1037 1037 1037 1037 1037 1037 1037 1037 1037 1905 1570 1822 1570 1570 1570 1570 1570 1822 1570 1830 1037 1544 1455 1628 1455 1712 1628 1975 1712 1628 1975 2051 2051 2051 2051 2051 1003 1004 2051 2051 2051 2051 2051 2051 2051 2051 1037 1 2 0 1 2 0
85 86 87 85 86 87 85 86 87 85 86 87 85 86 87 85 1370 1037 1037 1037 1037 1037 1037 1037 1037 1037 1037 1037 1037 1037 1037 1037 1037 1037 1037 1037 1037 1037 1037 1037 1037 1905 1570 1570 1570 1570 1910 1570 1570 1570 1570 1915 1628 1455 1712 1628 1975 2051 2051 2051 2051 2051 2051 2051 2051 2051 2051 2051 1088 1089 2051 2051 2051 2051 2051 2051 2051 2051 1037 86 87 85 86 87 85
170 171 172 170 171 172 170 171 172 170 171 172 170 171 1037 1037 1455 1370 1037 1037 1037 1037 1037 1037 1037 1037 1037 1037 1037 1037 1037 1037 1037 1037 1037 1037 1037 1037 1037 1370 1037 1990 1570 1570 1570 1570 1995 1570 1570 1570 1570 2000 1628 1975 2051 2051 2051 2051 2051 2051 2051 2051 2051 2051 2051 2051 2051 2051 1173 1174 2051 2051 2051 2051 2051 2051 2051 2051 1037 171 172 170 171 172 170
0 1 2 0 1 2 0 1 2 0 1 2 0 1037 1037 1037 1455 1455 1370 1037 1544 1037 1037 1037 1037 1037 1037 1370 1037 1544 1370 1037 1544 1037 1037 1037 1037 1037 1037 1627 1628 2075 2076 2076 2076 2079 2080 2076 2076 2076 2076 2085 2051 2051 2051 2051 2051 2051 2051 2051 2051 2051 2051 2051 2051 2051 2051 2051 2051 2051 2051 2051 2051 2051 2051 2051 2051 2051 1037 1 2 0 1 2 0
85 86 87 85 86 87 85 86 87 85 86 87 1037 1037 1037 2051 2051 2051 1455 1628 1455 1037 1037 1037 1037 1037 1037 1455 1628 1455 1455 1628 1455 1370 1037 1544 1037 1037 1037 1455 1628 1975 2051 2051 2051 2569 2569 2051 2051 2051 2051 2051 2051 2051 2051 2051 2051 2051 2051 2051 2051 2051 2051 2051 2051 2051 2051 2051 2051 2051 2051 2051 2051 2051 2051 2051 2051 2051 1037 86 87 85 86 87 85
170 171 172 170 171 172 170 171 172 170 171 1037 1037 1037 2051 2051 2051 2051 1712 1628 1455 1370 1037 1544 1037 1037 1037 1455 1628 1975 1712 1628 1975 1455 1628 1455 1370 1037 1544 1455 2051 2051 2051 2051 2051 2569 2569 2051 2051 2051 2051 2051 2051 2051 2051 2051 2051 2051 2051 2051 2051 2051 2051 2051 2051 2051 2051 2051 2051 2051 2051 2051 2051 2051 2051 2051 2051 2051 1037 171 172 170 171 172 170
0 1 2 0 1 2 0 1 2 0 1037 1037 1037 2051 2051 2051 2051 2051 2051 2051 1885 1455 1628 1455 1370 1037 1544 1975 2051 2051 2051 2051 2051 1712 1628 1975 1455 1628 1455 1975 2051 2051 2051 2051 2051 2569 2569 2051 2051 2051 2051 2051 2051 2051 2051 2051 2051 2051 2051 2051 2051 2051 2051 2051 2051 2051 2051 2051 2051 2051 2051 2051 2051 2051 2051 2051 2051 1037 1037 1 2 0 1 2 0
85 86 87 85 86 87 85 86 87 1037 1037 1037 2051 2051 2051 2051 2051 2051 2051 2051 2051 1712 1628 1455 1455 1628 1455 2051 2051 2051 2051 2051 2051 2051 2051 2051 1712 1628 1975 2051 2051 2051 2051 2051 2051 2569 2569 2051 2051 2051 2051 2051 2051 2051 2051 2051 2051 2051 2051 2051 2051 2051 2051 2051 2051 2051 2051 2051 2051 2051 2051 2051 2051 2051 1037 1037 1037 1037 85 86 87 85 86 87 85
170 171 172 170 171 172 170 171 1037 1037 1037 2051 2051 2051 2051 2051 2051 2051 2051 2051 2051 2051 2051 2051 1712 1628 1975 2051 2051 2051 2051 2051 2051 2051 2051 2051 2051 2051 2051 2051 2051 2051 2051 2051 2051 2569 2569 2051 2051 2051 2051 2051 2051 2051 2051 2051 2051 2051 2051 2051 2051 2051 2051 2051 2051 2051 2051 1037 1037 1037 1037 1037 1037 1037 1037 170 171 172 170 171 172 170 171 172 170
0 1 2 0 1 2 1037 1037 1037 1037 1037 2051 2051 2051 2051 2051 2051 2051 2051 2051 2051 2051 2051 2051 2051 2051 2051 2051 2051 2051 2051 2051 2051 2051 2051 2051 2051 2051 2051 2051 2051 2051 2051 2051 2051 2569 2569 2051 2051 2051 2051 2051 2051 2051 2051 2051 2051 2051 2051 2051 2051 2051 2051 2051 2051 2051 2051 1037 2 0 1 2 0 1 2 0 1 2 0 1 2 0 1 2 0
85 86 87 85 86 1037 1037 1037 1037 1037 2051 2051 2051 2051 2051 2051 2051 2051 2051 2051 2051 2051 2051 2051 2051 2051 2051 2051 2051 2051 2051 2051 2051 2051 2051 2051 2051 2051 2051 2051 2051 2051 2051 2051 2051 2569 2569 2051 2051 2051 2051 2051 2051 2051 2051 2051 2051 2051 2051 2051 2051 2051 2051 2051 2051 2051 2051 1037 1037 85 86 87 85 86 87 85 86 87 85 86 87 85 86 87 85
170 171 172 170 1037 1037 1037 1037 1037 2051 2051 2051 2051 2051 2051 2051 2051 2051 2051 2051 2051 2051 2051 2051 2051 2051 2051 2051 2051 2051 2051 2051 2051 2051 2051 2051 2051 2051 2051 2051 2051 2051 2051 2051 2051 2569 2569 2051 2051 2051 2051 2051 2051 2051 2051 2051 2051 2051 2051 2051 2051 2051 2051 2051 2051 2051 2051 2051 1037 1037 171 172 170 171 172 170 171 172 170 171 172 170 171 172 170
0 1 2 1037 1037 1037 1037 1037 2051 2051 2051 2051 2051 2051 2051 2051 2051 2051 2051 2051 2051 2051 2051 2051 2051 2051 2051 2051 2051 2051 2051 2051 2051 2051 2051 2051 2051 2051 2051 2051 2051 2051 2051 2051 2051 2569 2569 2051 2051 2051 2051 2051 2051 2051 2051 2051 2051 2051 2051 2051 2051 2051 2051 2051 2051 2051 2051 2051 2051 1037 1037 1037 0 1 2 0 1 2 0 1 2 0 1 2 0
1037 1037 1037 1037 1037 1037 2051 2051 2051 2051 2051 2051 2051 2051 2051 2051 2051 2051 2051 2051 2051 2051 2051 2051 2051 2569 2569 2569 2569 2569 2569 2569 2569 2569 2569 2569 2569 2569 2569 2569 2569 2569 2569 2569 2569 2569 2569 2051 2051 2051 2051 2051 2051 2051 2051 2051 2051 2051 2051 2051 2051 2051 2051 2051 2051 2051 2051 2051 2051 2051 2051 2051 1037 1037 1037 85 86 87 85 86 87 85 86 87 85
1037 1037 1037 1037 1037 2051 2051 2051 2051 2051 2051 2051 2051 2051 2051 2051 2051 2051 2051 2051 2051 2051 2051 2051 2051 2569 2569 2569 2569 2569 2569 2569 2569 2569 2569 2569 2569 2569 2569 2569 2569 2569 2569 2569 2569 2569 2569 2051 2051 2051 2051 2051 2051 2051 2051 2051 2051 2051 2051 2051 2051 2051 2051 2051 2051 2051 2051 2051 2051 2051 2051 2051 2051 2051 1037 1037 1037 172 170 171 172 170 171 172 170
1037 1037 2051 2051 2051 2051 2051 2051 2051 2051 2051 2051 2051 2051 2051 2051 2051 2051 2051 2051 2051 2051 2051 2051 2051 2569 2569 2051 2051 2051 2051 2051 2051 2051 2051 2051 2051 2051 2051 2051 2051 2051 2051 2051 2051 2051 2051 2051 2051 2051 2051 2051 2051 2051 2051 2051 2051 2051 2051 2051 2051 2051 2051 2051 2051 2051 2051 2051 2051 2051 2051 2051 2051 2051 2051 2051 1037 1037 0 1 2 0 1 2 0
1037 1037 2051 2051 2051 2051 2051 2051 2051 2051 2554 2555 2556 2557 2558 2559 2560 2561 2562 2563 2564 2565 2566 2567 2568 2569 2570 2051 2051 2051 2051 2051 2051 2051 2051 2051 2051 2051 2051 2051 2051 2051 2051 2051 2051 2051 2051 2051 2051 2051 2051 2051 2051 2051 2051 2051 2051 2051 2051 2051 2051 2051 2051 2051 2051 2051 2051 2051 2051 2051 2051 2051 2051 2051 2051 2051 2051 1037 85 86 87 85 86 87 85
1037 1037 1037 2051 2051 2051 2051 2051 2051 2051 2639 2640 2641 2642 2643 2644 2645 2646 2647 2648 2649 2650 2651 2652 2653 2654 2655 2051 2051 2051 2051 2051 2051 2051 2051 2051 2051 2051 2051 2051 2051 2051 2051 2051 2051 2051 2051 2051 2051 2051 2051 2051 2051 2051 2051 2051 2051 2051 2051 2051 2051 2051 2051 2051 2051 2051 2051 2051 2051 2051 2051 2051 2051 2051 2051 1037 1037 1037 170 171 172 170 171 172 170
1037 1037 1037 2051 2051 2051 2051 2051 2051 2051 2724 2725 2726 2727 2728 2729 2730 2731 2732 2733 2734 2735 2736 2737 2738 2739 2740 2051 2051 2051 2051 2051 2051 2051 2051 2051 2051 2051 2051 2051 2051 2051 2051 2051 2051 2051 2051 2051 2051 2051 2051 2051 2051 2051 2051 2051 2051 2051 2051 2051 2051 2051 2051 2051 2051 2051 2051 2051 2051 2051 2051 2051 2051 2051 1037 1037 1037 1037 0 1 2 0 1 2 0
1037 1037 1037 1037 2051 2051 2051 2051 2051 2051 2809 2810 2811 2812 2813 2814 2815 2816 2817 2818 2819 2820 2821 2822 2823 2824 2825 2051 2051 2051 2051 2051 2051 2051 2051 2051 2051 2051 2051 2051 2051 2051 2051 2051 2051 2051 2051 2051 2051 2051 2051 2051 2051 2051 2051 2051 2051 2051 2051 2051 2051 2051 2051 2051 2051 2051 2051 2051 2051 2051 2051 2051 2051 1037 1037 1037 1037 1037 85 86 87 85 86 87 85
1037 1037 1037 1037 2051 2051 2051 2051 2051 2051 2894 2895 2896 2897 2898 2899 2900 2901 2902 2903 2904 2905 2906 2907 2908 2909 2910 2051 2051 2051 2051 2051 2051 2051 2051 2051 2051 2051 2051 2051 2051 2051 2051 2051 2051 2051 2051 2051 2051 2051 2051 2051 2051 2051 2051 2051 2051 2051 2051 2051 2051 2051 2051 2051 2051 2051 2051 2051 2051 2051 2051 2051 1037 1037 1037 1037 1037 1037 170 171 172 170 171 172 170
1037 1037 1037 1037 1037 2051 2051 2051 2051 2051 2979 2980 2981 2982 2983 2984 2985 2986 2987 2988 2989 2990 2991 2992 2993 2994 2995 2051 2051 2051 2051 2051 2051 2051 2051 2051 2051 2051 2051 2051 2051 2051 2051 2051 2051 2051 2051 2051 2051 2051 2051 2051 2051 2051 2051 2051 2051 2051 2051 2051 2051 2051 2051 2051 2051 2051 2051 2618 2051 2051 2051 1037 1037 1037 1037 1037 1037 1037 0 1 2 0 1 2 0
1037 1037 1037 1037 1037 1037 1037 2051 2051 2051 3064 3065 3066 3067 3068 3069 3070 3071 3072 3073 3074 3075 3076 3077 3078 3079 3080 2051 2051 2051 2051 2051 2051 2051 2051 2051 2051 2051 2051 2051 2051 2051 2051 2051 2051 2051 2051 2051 2051 2051 2051 2051 2051 2051 2051 2051 2051 2051 2051 2051 2051 2051 2051 2051 2051 2051 2051 2051 2051 2051 1037 1037 1037 1037 1037 1037 1037 1037 85 86 87 85 86 87 85
1455 1037 1037 1037 1037 1037 1037 1037 1037 1037 3149 3150 3151 3152 3153 3154 3155 3156 3157 3158 3159 3160 3161 3162 3163 3164 3165 2051 2051 2051 2051 2051 2051 2051 2051 2051 2051 2051 2051 2051 2051 2051 2051 2051 2051 2051 2051 1037 1037 1037 1037 1037 1037 2051 2051 2051 2051 2051 2051 2051 2051 2051 2051 2051 2051 2051 2051 2051 2051 1037 1037 1037 1037 1037 1037 1037 1037 1037 170 171 172 170 171 172 170
1455 1542 1543 1544 1037 1037 1037 1037 1037 1037 3234 3235 3236 3237 3238 3239 3240 3241 3242 3243 3244 3245 3246 3247 3248 3249 3250 1037 1037 1037 1037 1037 1037 1037 1037 1037 1037 1037 1037 1037 1037 1037 1037 1037 1037 1037 1037 1037 1037 1542 1543 1544 1037 1037 1037 1037 2051 2051 2051 2051 2051 2051 2051 2051 1037 1037 1037 1037 1037 1037 1037 1037 1037 1037 1037 1037 1037 2 0 1 2 0 1 2 0
1455 1455 1628 1455 1542 1543 1544 1037 1037 1037 3319 3320 3321 3322 3323 3324 3325 3326 3327 3328 3329 3330 3331 3332 3333 3334 3335 1037 1542 1543 1544 1037 1037 1037 1037 1037 1037 1037 1037 1037 1037 1037 1037 1037 1037 1037 1542 1543 1544 1455 1628 1455 1542 1543 1544 1037 1037 1037 1037 1037 1037 1037 1037 1037 1037 1037 1037 1037 1037 1037 1037 1037 1037 1037 1037 1037 86 87 85 86 87 85 86 87 85
1455 1455 1628 1455 1455 1628 1455 1542 1543 1544 1455 1628 1455 1455 1628 1455 1542 1543 1544 1542 1543 1544 1037 1037 1037 1542 1543 1544 1455 1628 1455 1542 1543 1544 1037 1037 1037 1542 1543 1544 1542 1543 1544 1037 1037 1037 1455 1628 1455 1455 1628 1455 1455 1628 1455 1542 1543 1544 1542 1543 1544 1037 1037 1037 1542 1543 1544 1542 1543 1544 1542 1543 1544 1542 1543 1544 171 172 170 171 172 170 171 172 170
1455 1455 1628 1455 1455 1628 1455 1455 1628 1455 1455 1628 1455 1455 1628 1455 1455 1628 1455 1455 1628 1455 1542 1543 1544 1455 1628 1455 1455 1628 1455 1455 1628 1455 1542 1543 1544 1455 1628 1455 1455 1628 1455 1542 1543 1544 1455 1628 1455 1455 1628 1455 1455 1628 1455 1455 1628 1455 1455 1628 1455 1542 1543 1544 1455 1628 1455 1455 1628 1455 1455 1628 1455 1455 1628 1455 1 2 0 1 2 0 1 2 0
1455 1455 1628 1455 1455 1628 1455 1455 1628 1455 1455 1628 1455 1455 1628 1455 1455 1628 1455 1455 1628 1455 1455 1628 1455 1455 1628 1455 1455 1628 1455 1455 1628 1455 1455 1628 1455 1455 1628 1455 1455 1628 1455 1455 1628 1455 1455 1628 1455 1455 1628 1455 1455 1628 1455 1455 1628 1455 1455 1628 1455 1455 1628 1455 1455 1628 1455 1455 1628 1455 1455 1628 1455 1455 1628 1455 86 87 85 86 87 85 86 87 85
